Vocabularies = Wörterbücher
No data = Keine Dataien
Show answer = Antwort anzeigen
Previous page = Vorherige Seite
Next page = Nächste Seite
First page = Erste Seite
Last page = Letzte Seite
Filter by level: = Nach Niveau filtern:
Quick search: = Schnellsuche:
Filter by tag: = Nach Tag filtern:
Search... = Suchen...
Enter a word to search / = Geben Sie ein Suchwort ein /
Go back = Zurück
Quit = Beenden
Discard Changes = Änderungen verwerfen
Save = Speichern
Cancel = Stornieren
Upload all = Alle Dateien hochladen
Choose a media-file = Wählen Sie eine Mediendatei aus
Copy link = Link kopieren
Delete = Löschen
Load Audio = Audio laden
Vocabulary: = Wörterbuch:
Replace: = Ersetzen
Replace all = Ersetzen alles
File: = Datei:
Media: = Mediendatei:
Pronunciation: = Aussprache:
Tag: = Tag:
Level: = Niveau:

Show list of actions = Aktionsliste anzeigen
Hide actions/Clear messages = Aktionen ausblenden/Nachrichten löschen
Login = Login
Logout = Abmelden
Repeat last action = Letzte Aktion wiederholen
Select first item = das erste Element auswählen
Select last item = das letzte Element auswählen
Select next item = das nächste Element auswählen
Select prev item = das vorherige Element auswählen
New vocabulary (SUPERUSER) = Wörterbuch erstellen (SUPERUSER)
Rename vocabulary (SUPERUSER) = Wörterbuch umbenennen (SUPERUSER)
Delete vocabulary (SUPERUSER) = Wörterbuch löschen (SUPERUSER)
Go = Los geht's
Print ID of the selected item = Druck ID des ausgewählten Elements
Switch theme = Thema wäscheln
Shortkeys = Tastenkombinationen
(Press ESC to hide) = (zum Ausblenden ESC drücken)
Already authenticated = Bereits authentifiziert
Rename: = Neuer Name:
Delete [yes|no]? = Löschen [ja|nein]?
no = nein

Select first note = die erste Note auswählen
Select last note = die letzte Note auswählen
Select next note = die nächste Note auswählen
Select prev note = die vorherige Note auswählen
New note (SUPERUSER) = Note erstellen (SUPERUSER)
Rename note (SUPERUSER) = Note umbenennen (SUPERUSER)
Edit note (SUPERUSER) = Note bearbeiten (SUPERUSER)
Delete note (SUPERUSER) = Note löschen (SUPERUSER)
Quick Search = Schnellsuche
Global Search = Globale Suche
Play audio = Audio abspielen
Show answer to the task = Antwort auf die Aufgabe anzeigen
Print ID of note = Druck ID der ausgewählten Note

Page %d% = Seite $1
Page: %d% of %d% = Seite: $1 von $2